13 24
XXXXXXXXXXXXXXXXXXXXXXXX
X|||+|||||||+||+|||||||X
X|--|-------|---|--.--|X
X|--+.......|---|--.--|X
X|..|-------|---|--.--|X
X|--|||||||||||||--.--|X
X|--|---.---|---|--.--|X
X|||+|||||||+...|||||||X
X|--|-------|------+--|X
X+||||||||||+|||||||..|X
X|----|--.---------|---X
X||||||||||||||+||||---X
XXXXXXXXXXXXXXXXXXXXXXXX
12
H 4 5 N |
H 8 9 N |
H 9 3 N .
H 17 11 N |
H 21 6 N -
B 14 1 W |
B 5 7 W |
B 13 7 W .
C 18 1 E |
C 8 5 E |
T 1 1 E |
T 19 9 W |
